+--+--+--+--+--+--+--+--+--+--+--+--+--+--+--+
|p       |                    |        |     |
+--+  +  +--+  +--+--+--+--+  +  +  +  +--+  +
|     |     |              |     |  |        |
+  +--+--+  +  +--+--+--+--+--+--+  +--+--+--+
|        |  |  |                 |  |        |
+--+--+  +  +--+  +--+--+--+--+  +  +  +--+  +
|        |        |        |     |  |  |     |
+  +--+--+--+--+--+  +  +--+  +--+  +  +  +--+
|                 |  |  |     |     |  |     |
+  +--+--+--+--+  +  +  +  +--+  +--+  +--+  +
|     |        |  |  |     |     |     |  |  |
+--+  +  +--+  +  +  +--+--+--+  +  +--+  +  +
|     |     |     |  |           |     |  |  |
+--+--+--+  +--+--+  +  +  +--+--+--+  +  +  +
|           |     |  |  |                 |  |
+  +--+--+--+  +--+  +  +--+--+--+--+  +--+  +
|  |  |  |           |     |        |  |     |
+  +  +  +  +--+--+--+--+--+  +--+  +--+  +  +
|     |                       |           | g|
+--+--+--+--+--+--+--+--+--+--+--+--+--+--+--+
