+--+--+--+--+--+--+--+--+--+--+
|p    |           |           |
+  +  +  +  +--+  +  +--+--+  +
|  |  |  |  |  |  |        |  |
+  +--+  +  +  +  +--+--+  +  +
|  |     |  |  |  |        |  |
+  +  +--+  +  +  +  +--+--+  +
|     |     |        |     |  |
+--+--+  +--+--+--+--+  +  +  +
|        |     |        |  |  |
+  +--+--+  +  +  +--+--+  +  +
|           |  |  |  |     |  |
+  +--+--+--+  +  +  +  +--+--+
|  |        |  |  |  |        |
+  +--+--+  +  +  +  +--+--+  +
|     |     |  |  |     |     |
+--+  +  +--+  +  +  +--+  +  +
|  |  |     |     |  |     |  |
+  +  +--+  +--+--+  +  +--+  +
|                    |  |    g|
+--+--+--+--+--+--+--+--+--+--+


